лллллл  лллллл  лллллл  лллллл   л    л
л    л  л       л    л  л     л  л    л
лллллл  лллллл  лллллл  л     л  л    л
л       л       л  л    л     л  л    л
л       лллллл  л    л  лллллл   лллллл
                                       
ллллллллллллллллллллллллллллллллллллллл

appuyez sur n'importe quelle touche
pour retourner au menu