лллллл л    л ллллллл ллллллл лллллл  л   л
л      лл   л л     л л     л л    л   л л 
лллллл л л  л л     л л     л лллллл    л  
     л л  л л л     л л     л л         л  
лллллл л   лл ллллллл ллллллл л         л  