FDBBAFนษอออออออออออออออออออออออป
บ     Û ๕Û       Û   Û ๕บ
บ Û Û    Û    Û  Û Û   Ûบ
บÛÛ ÛÛÛÛÛÛ    Û    ÛÛÛ Ûบ
บ       Û   þÛÛÛÛÛÛÛ Û  บ
บ  ÛÛ   Û  Û   Û     Û  บ
บ  ๕Û   Û  Û   Û  Û  Û  บ
บÛÛÛÛ   Û  Û   Û  Û  Û  บ
บ          Û      Û     บ
บ ÛÛÛÛÛÛÛÛÛÛÛþþÛÛÛÛÛÛÛÛÛบ
บ       Ûฒฒฒ   Û        บ
บ ÛÛÛÛÛ Ûฒฒฒ   Û     ÛÛÛบ
บ Û ๕   Û             ๕ บ
ศอออออออออออออออออออออออผ