DDDDADนษอออออออออออออออออออออออป
บ                ฯ      บ
บ  ๕        þ           บ
บ                       บ
บ       ฒ          Û    บ
บ                 Û  Û  บ
บ  ฎ       ฒ       ณ ฒ  บ
บ                    ฒ ๕บ
บ         ฏ       ฤ  ฒ  บ
บ                    Û  บ
บ   ฒ                   บ
บ Û         ÛÛÛ         บ
บ   ๕    ฒ              บ
ศอออออออออออออออออออออออผ