CDDDACนษอออออออออออออออออออออออป
บ                ฯ      บ
บ  ๕        þ           บ
บ                    ฒ  บ
บ       ฒ     ค    Û    บ
บ                 Û     บ
บ  ฎ       ฒ       ณ    บ
บ                       บ
บ     ค   ฏ       ฤ     บ
บ                    ฒ  บ
บ   ฒ                   บ
บ Û         ÛÛÛ     ฒ   บ
บ   ๕    ฒ              บ
ศอออออออออออออออออออออออผ