BHษอออออออออออออออออออออออป
บ                ฯ      บ
บ       ฒ   þ    þþþ    บ
บ                þ๕     บ
บ       ฒ        þฒฒฎฒ  บ
บ           |           บ
บ          |๕|    |     บ
บ           |           บ
บ           ฏ    ฤ      บ
บฒฒฒฒฒ             ฒ๕   บ
บ๕                 ฒ    บ
บ           ÛÛÛ     ฒฒ  บ
บ                       บ
ศอออออออออออออออออออออออผ