CDGDAEนษอออออออออออออออออออออออป
บ      Û          ๕     บ
บ      Û         ÛÛ     บ
บ                       บ
บ          ฤ            บ
บ    Û              ฤ   บ
บ                       บ
บ  ฤ            ฤ       บ
บ          ÛÛ           บ
บ                       บ
บ  ÛÛÛ         Û    ๕   บ
บ ๕                     บ
บ        ฤ ๕            บ
ศอออออออออออออออออออออออผ