DDACÉÍÍÍÍÍÍÍÍÍÍÍÍÍÍÍÍÍÍÍÍÍÍÍ»
º                Ï      º
º  õ        þ           º
º                       º
º             ¤    Û    º
º                 Û     º
º  ®               |    º
º                       º
º     ¤   ¯       Ä     º
º                       º
º                       º
º Û         ÛÛÛ         º
º   õ                   º
ÈÍÍÍÍÍÍÍÍÍÍÍÍÍÍÍÍÍÍÍÍÍÍÍ¼