DDDDADЙЩЭЭЭЭЭЭЭЭЭЭЭЭЭЭЭЭЭЭЭЭЭЭЭЛ
К                Я      К
К  ѕ        ў           К
К                       К
К       В          л    К
К                 л  л  К
К  Ў       В       Г В  К
К                    В ѕК
К         Џ       Ф  В  К
К                    л  К
К   В                   К
К л         ллл         К
К   ѕ    В              К