лллллллл
л Я  ѕ л
л   Ў  л
л В    л
лллллллл