DDACษอออออออออออออออออออออออป
บ                ฯ      บ
บ  ๕        þ           บ
บ                       บ
บ       ฒ               บ
บ                       บ
บ  ฎ              |     บ
บ                       บ
บ        ฏ       ฤ      บ
บ                       บ
บ   ๕                   บ
บ           ÛÛÛ     ฒ   บ
บ                       บ
ศอออออออออออออออออออออออผ