EDDDAEนษออออออออออออออออออออออป
บ                ฯ      บ
บ       ฒ   þ    þþþ    บ
บ                þ๕     บ
บ       ฒ        þฒฒฎฒ  บ
บ           ณ           บ
บ          ณ๕ณ    ณ     บ
บ           ณ           บ
บ           ฏ    ฤ      บ
บฒฒฒฒฒ             ฒ๕   บ
บ๕                 ฒ    บ
บ           ÛÛÛ     ฒฒ  บ
บ                       บ
ศอออออออออออออออออออออออผ