BDDDACนษอออออออออออออออออออออออป
บ                ฯÛ  ฏ  บ
บ          þ      Û   ๕ บ
บ                 Û     บ
บ       ฒ         ÛÛÛÛÛÛบ
บ                       บ
บ  ฎ              ณ     บ
บ                       บ
บ                ฤ      บ
บ                       บ
บ   ๕                   บ
บ           ÛÛ      ฒ   บ
บ                       บ
ศอออออออออออออออออออออออผ