EDDDACนษอออออออออออออออออออออออป
บ                ฯ      บ
บ  ๕        þ           บ
บ                       บ
บ       ฒ          Û    บ
บ                 Û     บ
บ  ฎ       ฒ       ณ    บ
บ                       บ
บ         ฏ             บ
บ                       บ
บ   ฒ                ÛÛÛบ
บ Û         ÛÛÛ     ณ   บ
บ       ฒ           ฤ  ๕บ
ศอออออออออออออออออออออออผ