BDJHBCดษอออออออออออออออออออออออป
บ                ฯ      บ
บ           þ           บ
บ                       บ
บ       ฒ               บ
บ                       บ
บ  ฎ              ณ     บ
บ                       บ
บ        ฏ       ฤ      บ
บ                       บ
บ   ๕                   บ
บ           ÛÛÛ     ฒ   บ
บ                       บ
ศอออออออออออออออออออออออผ